Gg^Fmw, Gs, Gs^Fmw, Gg, Gs^Fp, Gg, Gll^Fp, Gll^Fmf, Gll^Fmw, Gg^Fmw, Re, Re, Gll^Fmf, Gll^Fmf, Gg^Fmf, Gg, Hh^Fmf, Gll^Fmw, Hh^Fmw, Gs, Gll^Fmw, Gg^Fmw, Hh^Fmw, Gs^Fp, Hh^Fp, Hh^Fp, Hh^Fmw, Ss, Wwrg, Gll^Fp, Ss^Em, Gll^Fdw, Sm, Gll^Fmw, Gll^Em, Ss, Gll^Em, Gll^Fmw, Gll^Fmw
Gs^Fmw, Gll^Fp, Gll^Fp, Gs^Fmw, Gs^Fmw, Gs, Gs^Fp, Gs, Gs, Gll^Fmw, Re, Gs^Fmw, Gll^Em, Gll^Fmf, Gll^Fmw, Gll^Fp, Hh^Fmf, Hh, Gll^Fmw, Gll^Fmw, Gs^Fmf, Gs^Em, Gs^Fmw, Hh, Hh^Fmw, Hh^Fp, Hh, Wwg, Ss, Ss^Em, Ss, Ss, Hh^Fmw, Sm, Ss^Tf, Ss^Emf, Gll^Em, Gll^Fmw, Gll^Fmw
Gs^Fmw, Gll, Gll^Emf, Gs^Fmw, Gg^Fmw, Gg^Fp, Gg^Fmw, Gg^Fmw, Re, Re, Gg^Efm, Gg^Fmw, Gs^Fmw, Gg^Fmw, Gll^Fp, Gll^Fmf, Gll^Fp, Gll^Fp, Gll^Em, Gs^Fmw, Gs^Fmf, Gs^Fmw, Gll^Fp, Hh^Fmw, Rb^Fmw, Hh^Fmw, Gll^Em, Hh^Fdw, Sm, Sm^Em, Rb^Emf, Rb^Fmw, Hh, Ss^Em, Ss^Em, Ss^Tf, Ss, Ss, Ss
Gll^Fp, Gs, Gs^Em, Gs^Fmw, Gs, Gg, Gs, Re^Es, 1 Re, Gg, Gll^Fmw, Gg, Gll, Gs, Gll^Fmw, Gll^Fmw, Gll^Fp, Gs^Fmw, Gll^Fmw, Gll^Fmf, Gll^Fmw, Rb^Fp, Sm, Hh, Rb, Rb^Em, Gll^Fdw, Sm, Sm^Vhs, Ss, Ss^Tf, Hh^Em, Gll^Fdw, Rb^Fdw, Ss, Ss^Vhs, Gll^Fdw, Rb^Fmw, Rb^Fmw
Gll^Fmw, Gll^Fmw, Gs, Gs, Gs, Gs, Gs, Re, Gll, Gll^Fmw, Gs, Gs, Gll^Em, Gll^Em, Gs^Fp, Gll^Fmw, Gg, Gs^Fmw, Rb^Fp, Gll^Fmw, Rb, Gll^Fmw, Sm^Vm, Ss, Ss, Rb^Fmw, Sm, Sm^Em, Sm, Ss, Ss, Hh^Em, Sm, Sm, Ss, Rb, Rb^Emf, Gll^Fmw, Gll^Fmw
Gll, Gll^Fmw, Gs, Gg^Efm, Gs^Fmw, Gg^Es, Gs, Gs, Gll, Gll^Em, Re, Gll^Fmw, Gll, Gs^Fmw, Gll^Em, Gll^Fmw, Gg^Efm, Gll^Fp, Gll^Em, Rb^Fp, Rb, Sm, Hh^Fmw, Hh, Sm^Em, Gll^Fdw, Gll^Fdw, Ss, Ss, Gll^Em, Ss, Rb^Fdw, Sm^Em, Rb^Fdw, Sm, Sm^Em, Sm^Em, Sm, Sm
Gll^Fmw, Gs^Em, Gll^Fmw, Gg, Gs, Gg, Gg, Gs, Gg, Re, Re, Re, Gs^Fmw, Gs, Gs^Fmw, Gg, Gs, Gs, Gll^Fmw, Gll^Fmw, Gs^Fp, Hh, Hh^Fmw, Gs^Fmf, Gs^Fmf, Gll^Fp, Gll^Fmw, Rb, Gll^Fmw, Ss, Rb^Fdw, Ss, Chs, Chs, 4 Khs, Sm, Sm, Wwg, Rb
Gg, Gg^Fmw, Gg^Fp, Gll^Fmw, Gg, Gs^Fmw, Gll^Fmw, Gg^Efm, Gg, Gs, Gd, Re, Gd, Gs^Fp, Gg^Fmw, Gs, Gg^Efm, Gs, Gs^Em, Gs^Fmf, Gg^Fmf, Gll^Fmw, Gll^Fmf, Gll^Fp, Gg^Fmf, Hh^Fmf, Hh^Fmf, Gll^Fp, Hh^Fmw, Hh^Fdw, Sm^Em, Rb^Em, Chs, Chs, Ss, Ss, Wwg, Wwg^Ewl, Rb^Fmw
Gll^Fmf, Gg^Fp, Gll^Fmf, Gg^Fp, Gll^Fmw, Gs^Fmw, Gs, Gg, Gs, Gg, Gs, Gd, Re, Gd, Re, Gs, Gs^Fp, Gg^Fmw, Gs^Fmf, Gg^Fp, Gll^Fmf, Gll^Fp, Gll^Fp, Gll^Fmf, Gll^Fp, Hh, Gs^Em, Gll^Fp, Gll^Fp, Hh^Fdw, Hh, Sm, Rb, Rb^Em, Ss, Gll^Fdw, Rb^Fmw, Gll^Fmw, Gll^Fmw
Gll^Fp, Gll^Fmf, Gg^Fp, Gll^Fmw, Gs^Fmw, Gs^Fmw, Gs, Gs^Es, Gs^Fp, Gs^Fmw, Gs, Gs, Re^Gvs, Re^Es, Gd, Re, Re, Gll^Fmw, Gg^Fp, Gs^Fmf, Gs^Fmw, Gll^Fmf, Gs^Fmw, Gll^Fmw, Gs^Fmw, Gs^Fmw, Gll^Fp, Gll^Fmw, Hh^Fmw, Hh^Fmw, Hh^Fdw, Sm, Rb^Fdw, Gll^Fmw, Ss^Em, Ww^Vm, Wwg^Ewl, Rb, Rb
Gll^Fp, Gll^Fmf, Gll^Fmf, Gs^Em, Gll^Fmw, Gs^Fmw, Gll^Em, Gs^Fmw, Gs, Gs^Fmw, Gs^Vc, Re^Gvs, Re^Gvs, Re^Gvs, Re^Gvs, Gd, Re, Gs, Gs^Fmw, Gs^Fmw, Gs, Gs^Fp, Gs, Gs, Gs^Fmw, Gll^Fp, Gs^Em, Gs^Fmw, Gll^Fp, Gll^Fp, Gs^Fmw, Hh, Gll^Fmw, Ss^Emf, Gll^Fdw, Hh^Em, Hh^Fmw, Hh, Hh
Gll^Fp, Gll^Fp, Gll^Fmf, Gll^Fmw, Gll^Fp, Gll^Emf, Gll^Fmw, Gll, Gs, Gs, Gs^Fmw, Re^Gvs, Re^Gvs, Re^Gvs, Gd, Gd, Re, Re, Gd, Gd, Gd^Fmw, Gs^Em, Gs, Gs, Gs, Gs, Gs, Gs^Fmw, Gg, Gs, Gs^Fmw, Gll^Fp, Gll^Fp, Hh, Hh^Fmw, Hh, Hh^Fmw, Hh^Fmw, Hh^Fmw
Gg, Gll^Fmw, Gll^Fp, Gll^Fmw, Gll^Fmw, Gll^Fp, Gll^Fmw, Gs, Gs, Gg^Fp, Gs, Gs, Gs, Gd, Re, Gd, Re^Es, Re^Es, Ce, Gd, Rd, Gd^Fdw, Re^Es, Re, Gd^Fmw, Gs, Gs^Fmw, Re, Re, Hh, Gs, Hh, Hh, Gll^Fp, Gll^Fmw, Gll^Fp, Gll^Fp, Gll^Fp, Gll^Fp
Gll^Fmw, Gll^Fmw, Gll^Fmw, Gs^Em, Gs, Gs^Fp, Gll^Fmw, Gll^Fmw, Gll^Fmw, Gs, Gs, Gs, Gs, Gs, Gs, Re, Re, Ce, Gd, Gd, Re, Re, Gd^Fdw, Gd, Gs^Fp, Gs^Fp, Gg, Hh, Hh^Fp, Re, Re^Es, Hh^Fp, Gs, Gll^Fmw, Hh, Gll^Fmw, Gs^Em, Gg^Efm, Gll^Fp
Ww, Gs^Em, Gll^Fmw, Gs, Gs, Gll^Fmw, Gs, Gll, Gs, Gg, Gg, Gs^Fmw, Gs^Fp, Gs^Fmw, Gd, Re, Gd, Re, Ce, Rd, Ce, Re, Rd^Vh, Ce, Gd, Gs^Fmw, Gs, Gg^Efm, Hh^Fmw, Hh^Fp, Re, Hh, Gs^Fmw, Gs^Em, Hh, Gs^Fdw, Hh^Fp, Hh, Hh
Gs^Fdw, Ww, Ww, Gll^Fp, Ww, Gs, Gll^Fp, Gll^Em, Gll^Fp, Gg^Fp, Gg^Fmw, Gs, Gs^Fp, Gs^Fmw, Gs^Fmw, Re^Vct, Gd^Fdw, Ce, Ce, Ke, Ce, Rd^Es, Gd, Ce, Hh^Fdw, Gd, Gs, Gg^Fmw, Gg, Hh, Re, Gg^Em, Gs, Gg^Fp, Gg, Hh^Fmw, Hh^Fmw, Hh^Fp, Hh^Fp
Gs^Fmw, Ww, Gg^Fp, Ww, Gg, Ww, Ww, Gll, Gs, Gll^Em, Gg, Gg^Efm, Gs^Fmw, Gs, Gs^Fmw, Gs^Fmw, Re, Rd^Vct, Rd, Gd, Gd, Gd^Vc, Gs, Gs, Gd, Gs, Hh, Gg, Gg, Gg^Efm, Gg, Re, Re, Gs, Hh, Hh, Gg^Fmw, Gg^Fmw, Gg^Fmw
Gs, Ww, Gg^Fmw, Gs, Gs, Gs^Fmw, Ww, Ww, Gs, Gll, Gs^Es, Gg, Gg, Gs, Gs, Gs, Re^Es, Re^Es, Re, Gd, Gd, Gd^Fdw, Hh, Gs, Gs^Fdw, Hh, Hh, Gg^Fp, Gg^Fmw, Gg^Fp, Gg^Fmw, Gg^Fmw, Gg^Efm, Re, Gs, Hh^Fmw, Gg^Efm, Gg^Fmw, Gg^Fmw
Ww, Ww, Gs, Gs^Fmw, Gs, Ww, Ww, Gg^Fp, Gg, Gs, Gs, Gg, Re, Re, Gg, Gd, Gd, Ce, Gd^Fdw, Gd, Hh, Hh, Hh, Hh^Fmw, Gs^Fp, Hh, Hh^Fp, Hh^Fmw, Hh^Fp, Gg, Hh, Gg^Fmw, Gg, Gs, Gg, Gs, Re, Hh, Hh
Gg, Gg, Gg, Gs, Gs^Fmw, Gg, Gs^Fmw, Ww, Ww, Gs^Fp, Gs^Fp, Re, Gs, Gg^Fp, Gg^Efm, Gg, Gg^Fp, Gg, Gg, Gs, Gd, Gd^Fmw, Gs^Em, Gg^Fmw, Hh^Fp, Gg, Hh^Fp, Hh, Hh, Hh^Fp, Gs^Em, Hh, Gg^Fp, Hh, Hh^Fmw, Hh, Gs^Fmw, Re^Es, Re
Gs, Gs^Fmw, Wwg^Ewl, Gll^Fmw, Gs^Fmw, Gs^Fp, Gs^Fp, Ww, Ww, Gg, Gs, Re, Gs, Gg, Gg, Gg^Fmw, Gs^Fmw, Gg^Efm, Gs, Gs, Gs, Gs, Hh^Fp, Gs, Hh, Hh, Hh^Fp, Hh, Gs^Fmw, Gs^Fp, Gd^Fmw, Gd^Es, Gd, Gs, Gs^Fmw, Hh^Fp, Gs, Gg, Gg
Gll^Fmw, Gll^Fmw, Wwg^Vm, Wwg, Gll, Gll^Fp, Gs^Em, Gll, Rb, Wwg, Wwg^Bw/, Re, Ce, Gs, Wwg, Gs, Gs^Fp, Hh, Hh^Fmw, Gs, Gg, Gg^Fmw, Gg^Es, Gs, Gg^Fmw, Hh^Fp, Gs^Em, Hh, Hh^Fp, Gd^Fmw, Re^Es, Re^Vct, Hh, Hh^Fmw, Gs^Em, Gd, Gs, Gs^Fp, Gs
Gll, Wwg, Rb, Wwg, Wwg, Gll^Fmw, Gll^Em, Gll^Fmw, Rb, Rb^Es, Gll^Fmw, Wwg, Wwg, Wwg, Sm, Wwg, Wwg, Wwg, Wwg, Gg^Em, Gg^Efm, Gs, Gs, Gs, Gs, Gs, Gd^Es, Hh, Hh^Fp, Gd^Fmw, Hh, Co, 3 Ko, Hh^Fdw, Co, Gd, Hh^Fmw, Gg^Fmw, Gg^Fp
Rb, Rb, Rb^Em, Rb^Fmw, Rb^Fdw, Rb, Gll^Fdw, Rb^Es, Rb^Fdw, Rb, Gll^Fdw, Wwg, Wwg^Ewl, Gll^Fdw, Rb^Fdw, Sm, Gs^Fmw, Gll^Fdw, Gll, Wwg, Wwg, Hh^Fdw, Hh, Hh^Fmw, Hh^Fp, Gd^Fp, Gd^Fmw, Gs, Hh^Fp, Hh^Vo, Re, Co, Co, Co, Hh, Hh^Fp, Hh^Fmw, Gg^Fp, Gg^Fp
Rb^Fmw, Gll^Fdw, Rb, Ss^Vhs, Ss^Em, Ss, Ss, Rb, Sm, Rb, Rb, Sm, Sm^Em, Sm, Sm, Sm, Gs^Fmw, Gs^Fmw, Gs^Fmw, Wwg, Wwg, Hh^Fmw, Gs^Fp, Hh, Gll^Fp, Gs, Gs^Em, Gd, Gd, Gd, Rb^Es, Re, Gs, Gs, Hh^Fdw, Hh^Vo, Gd^Fdw, Hh^Fmw, Hh
Rb, Gll^Fdw, Gll, Ss, Tb^Tf, Ss^Emf, Ss^Em, Rb, Sm, Ss, Ss^Vhs, Sm^Emf, Ss, Sm, Rb, Rb^Fdw, Gll^Fp, Rb^Fp, Gs^Em, Gs^Fdw, Wwg, Gs^Fmw, Gs^Fdw, Gll^Em, Rb^Fmw, Gll^Fmw, Gll^Emf, Gd^Fmw, Gll^Fdw, Rb, Rb^Es, Re, Re, Re^Vct, Hh, Re, Re^Es, Hh, Hh^Fdw
Ss, Ss, Gll^Em, Sm, Chs^Tf, Tb, Tb, Sm, Wwg, Ss, Ss, Ss^Em, Rb, Wwg^Ewl, Wwg, Rb^Fdw, Rb, Gll^Fmw, Gll^Fdw, Gs^Fdw, Wwg, Gll^Fmw, Gll, Gll^Fdw, Rb, Gll, Sm, Gll^Fdw, Sm^Em, Rb, Rb^Em, Gll^Fdw, Gll^Fmw, Hh, Re, Re^Ecf, Rb^Vct, Gd, Gd
Ss, Rb^Fdw, Rb^Em, Chs, 2 Khs, Tb, Chs, Sm, Sm, Wwrg, Wwg^Vm, Ss, Ss, Wwg, Ss, Sm, Sm, Sm, Wwg, Wwg, Gll, Sm, Sm, Rb^Em, Rb, Gll^Fdw, Sm, Ss, Ss, Sm^Em, Sm, Sm, Sm, Gll, Gd^Fdw, Re, Gs, Gs^Es, Gs
Gg, Ss, Rb^Em, Rb^Tf, Tb^Tf, Chs, Chs, Gll^Em, Tb, Wwg^Ewl, Wwg, Rb, Ss^Em, Ss, Ss, Sm, Sm, Wwg, Wwg, Wwg, Rb^Fmw, Sm^Em, Rb^Emf, Sm^Em, Hhd^Fdw, Sm, Hhd, Ss, Rb, Sm, Gll^Fdw, Gll^Fmw, Gll^Em, Gll, Gs^Fmw, Gd^Em, Hh^Fdw, Gd^Fdw, Gd^Em
Sm, Tb, Sm^Vhs, Rb^Emf, Rb^Fdw, Tb, Ss, Gll^Em, Tb^Tf, Gll^Fdw, Rb^Em, Rb^Fdw, Ss^Tf, Gll^Fdw, Gll^Fmw, Gll^Fdw, Wwg, Wwg, Sm, Sm^Em, Rb^Fp, Rb^Fdw, Ss^Em, Ss, Ss^Em, Hhd^Fmw, Wwrg, Hhd^Fdw, Sm^Em, Rb^Em, Ss^Em, Ss^Emf, Rb^Fdw, Rb, Rb, Hh, Gs^Em, Gs^Fmw, Hh^Fp
Sm, Sm, Tb^Tf, Sm, Sm, Tb, Ss, Ss^Vhs, Ss^Emf, Gll, Gll^Fmw, Rb^Emf, Rb^Fdw, Rb, Gll, Gll, Wwg, Gll, Gll^Fdw, Gll^Fdw, Rb^Fmw, Ss, Sm^Emf, Ss^Tf, Ss, Hhd, Wwrg, Sm, Rb, Rb^Fmw, Rb^Fdw, Ss^Tf, Ss, Gll^Fmw, Hh, Hh, Hh^Fp, Hh^Fmw, Hh^Fmw
Sm, Tb, Tb^Tf, Tb, Sm, Ss, Sm, Ss, Gll^Fdw, Gll^Em, Rb^Fdw, Gll^Fmw, Sm, Sm, Wwg, Wwg, Sm, Wwg, Gll^Fmw, Sm, Sm^Em, Sm^Em, Sm^Em, Ss, Ss, Wwg, Ss, Ss, Hhd, Hhd^Fdw, Sm, Ss, Ss^Em, Gll, Gll^Em, Hh^Fmw, Hh, Hh, Hh^Fp
Ss, Tb, Gll^Fdw, Gll^Emf, Rb, Sm^Em, Sm^Emf, Rb^Fdw, Rb, Rb, Sm, Gll, Wwg, Sm, Wwg, Gll^Fmw, Sm, Sm, Gll^Fmw, Wwg, Wwg^Ewl, Rb, Rb^Fdw, Hhd^Fmw, Hhd^Fdw, Hhd, Hhd^Fdw, Ss, Ss, Sm, Ss, Wwrg, Wwg, Gll^Fdw, Gll^Fmw, Gll^Fmw, Hh^Fp, Hh^Fp, Hh
Ss, Ss, Ss, Gll^Fdw, Rb, Sm, Rb, Rb, Rb, Rb, Gll, Sm, Wwg, Wwg, Wwg, Sm, Gg, Gll^Fdw, Gg, Wwg, Wwg, Wwg, Rb, Rb^Fmw, Rb, Sm, Gg, Gg, Gg, Sm, Ss, Wwg, Ss, Wwg, Gg, Hh, Gll, Hh, Hh
