Gll^Fp, Gg, Gs^Fms, Gg, Gll^Fp, Gs^Fms, Gs^Fms, Gll^Fp, Wwg, Wwg, Wwg, Gll^Fp, Gll^Fp, Gs^Fms, Gs^Fms, Gs^Fds, Gs^Fms, Gs^Fds, Gs^Fms, Gll^Fp, Gll^Fp, Gs^Fms, Gs^Fms
Gll^Fp, Gll^Fp, Gs^Fds, Gll^Fp, Gll^Fp, Gll^Fp, Wwg, Wwg, Wog, Wwg, Wwg, Wwg, Wwg, Gll^Fp, Wwg, Gll^Fp, Gll^Fp, Gll^Fp, Gs^Fms, Gll^Fp, Gg^Efm, Gs^Fms, Gs^Fms
Gll^Fp, Gg^Efm, Gll^Fp, Gs^Fds, Wwg, Wwg, Wog, Wog, Wwg, Wwg, Gs^Fms, Wwg, Wwg, Wwg, Wwrg, Wwg, Wwg, Wwg, Wwg, Gs^Fms, Gll^Fp, Gll^Fp, Gs^Fms
Gs^Fms, Gs^Fms, Gll^Fp, Wwg, Wwrg, Wwg, Wwg, Wog, Wwg, Gg^Efm, Cv, Gs^Fms, Cv, Wwg, Wwg, Wwg, Wwg, Wwg, Wog, Wwg, Wwg, Gll^Fp, Gs^Fms
Gll^Fp, Gs^Fms, Gs^Fds, Wwg, Wwg, Wwg, Gs^Fms, Wwrg, Cv, Gs^Fms, Cv, Kv, Cv, Gg^Efm, Cv, Gs^Fms, Gs^Fms, Wwg, Wog, Wog, Wwg, Gs^Fms, Gll^Fp
Gll^Fp, Gll^Fp, Wwg, Wwg, Wwg, Gs^Fms, Cv, Gg^Efm, Gg^Efm, Gs^Fms, Gg^Efm, Gg, Gs^Fms, Gg, Gg, Gs^Fms, Cv, Wwg, Wwg, Wog, Wwg, Wwrg, Wwrg
Wwg, Wwg, Wog, Wog, Wwrg, Gg^Efm, Kv, Cv, Gs^Fms, Gg, Rp, Rp, Rp, Gs^Fms, Gg^Efm, Cv, Kv, Gll^Fp, Gg^Efm, Wwg, Wwg, Wwrg, Wwrg
Wog, Wog, Wwg, Wwg, Gs^Fms, Cv, Cv, Gg, Rp, Rp, Wwg, Wwg, Wwg^Ewf, Rp, Rp, Gg^Efm, Cv, Cv, Gs^Fms, Wwrg, Wwg, Wog, Wog
Wwg, Wog, Wwg, Cv, Gs^Fms, Gs^Fms, Gg^Efm, Gs^Fms, Rp, Wwg^Ewl, Wwg^Ewl, Wwg^Ewf, Wwg^Ewl, Wwg^Ewl, Rp, Gg, Gg, Gs^Fms, Gg, Cv, Wwg, Wog, Wog
Wwg, Wwg, Wwg, Cv, Gg^Efm, Cv, Gg^Efm, Gs^Fms, Rp, Wwg^Ewf, Wwg^Ewf, Gs^Fet, Wwg^Ewf, Wwg, Rp, Gs^Fms, Gs^Fms, Cv, Gg^Efm, Cv, Wwg, Wog, Wog
Wwg, Wwg, Wwg, Cv, Gs^Fms, Gs^Fms, Cv, Gg^Efm, Rp, Wwg, Wwg, Wwg^Ewl, Wwg^Ewf, Wwg, Rp, Gs^Fms, Cv, Gg^Efm, Gg, Cv, Wwg, Wog, Wog
Wog, Wog, Wwg, Wwg, Wwg, Cv, Kv, Gg, Gs^Fms, Rp, Rp, Wwg^Ewl, Rp, Rp, Gg, Gg^Efm, Kv, Cv, Gs^Fms, Wwg, Wog, Wwg, Wwg
Wwg, Wog, Wwg, Wog, Wog, Wwg, Cv, Cv, Gs^Fms, Gs^Fms, Rp, Rp, Rp, Gg^Efm, Gg^Efm, Cv, Cv, Gs^Fms, Gs^Fms, Wwg, Wog, Wwg, Wwg
Gll^Fp, Wwg, Wwg, Wog, Wwg, Wwg, Gs^Fms, Gg^Efm, Cv, Kv, Rp, Rp, Rp, Kv, Cv, Gg, Wwg, Gg^Efm, Wwg, Wwg, Wwg, Wwg, Gll^Fp
Gll^Fp, Gll^Fp, Wwg, Wwg, Wwrg, Wwg, Wwg, Wwrg, Gs^Fms, Cv, Rp, Rp, Rp, Cv, Gs^Fms, Wwg, Wwg, Wwg, Wog, Wwrg, Wwg, Gll^Fp, Gll^Fp
Gs^Fms, Gll^Fp, Gs^Fms, Wwg, Wwg, Wog, Wog, Wwg, Wwg, Gs^Fms, Wwf, Wwf^Bsb|, Wwf, Gs^Fms, Wwg, Wwg, Wwg, Wog, Wwg, Wwg, Gg^Efm, Gll^Fp, Gs^Fms
Gll^Fp, Gs^Fms, Gs^Fds, Gg^Efm, Wwg, Wog, Wwrg, Wwg, Wog, Wwg, Wwf, Wwf^Bsb|, Wwf, Wwf, Wwg, Wog, Wog, Wwg, Gll^Fp, Gll^Fp, Gg^Efm, Gs^Fms, Gll^Fp
Gll^Fp, Gll^Fp, Gs^Fms, Gll^Fp, Gll^Fp, Wwg, Wwg, Wwg, Wwg, Wwg, Wwf, Wwf^Bsb|, Wwf, Wwg, Wwg, Wog, Wwg, Wwg, Gll^Fp, Gll^Fp, Gs^Fms, Gll^Fp, Gll^Fp
Gs^Fms, Gs^Fms, Gs^Fms, Gll^Fp, Gs^Fms, Gs^Fms, Gs^Fms, Gll^Fp, Cv, Wwf, Wwf, Wwf^Bsb|, Rp, Wwg, Cv, Wwg, Gll^Fp, Gs^Fms, Gs^Fds, Gs^Fms, Gs^Fms, Gs^Fds, Gs^Fms
Gll^Fp, Gll^Fp, Gg^Em, Gg^Efm, Gll^Fp, Gs^Fms, Gll^Fp, Gg^Fet, Cv, Kv, Rp, Rp, Rp, Kv, Cv, Gll^Fp, Gll^Fp, Gs^Fms, Gll^Fp, Gs^Fms, Gll^Fp, Gs^Fds, Gll^Fp
Gs^Fms, Gll^Fp, Gs^Fds, Gs^Fms, Gs^Fms, Gll^Fp, Gs^Fms, Gg^Efm, Gll^Fp, Cv, Rp, Rp, Rp, Cv, Gg^Fet, Gll^Fp, Gs^Fms, Gg^Efm, Gs^Fms, Gll^Fp, Gs^Fms, Gs^Fms, Gll^Fp
Gll^Fp, Gs^Fms, Gll^Fp, Gll^Fp, Gll^Fp, Gs^Fds, Gll^Fp, Gs^Fms, Gll^Fp, Gll^Fp, Rp, 1 Rp, Rp, Gll^Fp, Gll^Fp, Gs^Fms, Gll^Fp, Gll^Fp, Gs^Fms, Gg^Em, Gll^Fp, Gs^Fds, Gll^Fp
Gll^Fp, Gs^Fms, Gll^Fp, Gll^Fp, Gll^Fp, Gll^Fp, Gll^Fp, Gs^Fms, Gg, Gll^Fp, Rp, Rp, Rp, Gll^Fp, Gg, Gs^Fms, Gg, Gll^Fp, Gs^Fms, Gs^Fms, Gll^Fp, Gll^Fp, Gll^Fp
