Gll^Fp, Gg, Gs^Fms, Gg, Gll^Fp, Gs^Fms, Gs^Fms, Gll^Fp, Gs^Fms, Gs^Fds, Gs^Fds, Gll^Fp, Gll^Fp, Gs^Fms, Gs^Fms, Gs^Fds, Gs^Fms, Gs^Fds, Gs^Fms, Gll^Fp, Gll^Fp, Gs^Fms, Gs^Fms
Gll^Fp, Gll^Fp, Gs^Fds, Gll^Fp, Gll^Fp, Gll^Fp, Gs^Fms, Gs^Fms, Wwf, Wwf, Wwg, Wwg, Wwg, Gll^Fp, Gg^Efm, Gll^Fp, Gll^Fp, Gll^Fp, Gs^Fms, Gll^Fp, Gg^Efm, Gs^Fms, Gs^Fms
Gll^Fp, Gg^Efm, Gll^Fp, Gs^Fds, Gs^Fms, Gg^Efm, Gll^Fp, Gll^Fp, Wwg, Wwg, Wwg, Wwg, Wwg, Wwg, Wwrg, Wwf, Wwf, Gg^Efm, Gs^Fds, Gs^Fms, Gll^Fp, Gll^Fp, Gs^Fms
Gs^Fms, Gs^Fms, Gll^Fp, Gg^Efm, Wwrg, Wwg, Wwg, Wwg, Wwg, Gg^Efm, Cv, Gs^Fms, Cv, Wwg, Wwg, Wwg, Wwg, Wwg, Wwrg, Gg^Efm, Gs^Fds, Gll^Fp, Gs^Fms
Gll^Fp, Gs^Fms, Gs^Fds, Wwf, Wwg, Wwg, Gs^Fms, Wwrg, Cv, Gs^Fms, Cv, Kv, Cv, Gg^Efm, Cv, Gs^Fms, Gs^Fms, Wwg, Wwg, Gs^Fds, Gg^Efm, Gs^Fms, Gll^Fp
Gll^Fp, Gll^Fp, Gs^Fms, Wwg, Wwg, Gs^Fms, Cv, Gg^Efm, Gg^Efm, Gs^Fms, Gg^Efm, Gg, Gs^Fms, Gg, Gg, Gs^Fms, Cv, Wwg, Wwg, Wwf, Wwf, Gg^Efm, Gll^Fp
Gs^Fds, Gg^Efm, Wwg, Wwg, Wwrg, Gg^Efm, Kv, Cv, Gs^Fms, Gg, Rp, Rp, Rp, Gs^Fms, Gg^Efm, Cv, Kv, Gll^Fp, Gg^Efm, Wwg, Wwg, Gs^Fds, Gs^Fds
Wwg, Wwg, Wwg, Wwg, Gs^Fms, Cv, Cv, Gg, Rp, Rp, Wwg, Wwg, Wwg^Ewf, Rp, Rp, Gg^Efm, Cv, Cv, Gs^Fms, Wwrg, Wwg, Wwg, Wwg
Wwg, Wwg, Wwg, Cv, Gs^Fms, Gs^Fms, Gg^Efm, Gs^Fms, Rp, Wwg^Ewl, Wwg^Ewl, Wwg^Ewf, Wwg^Ewl, Wwg^Ewl, Rp, Gg, Gg, Gs^Fms, Gg, Cv, Wwg, Wwg, Wwg
Wwg, Wwg, Wwg, Cv, Gg^Efm, Cv, Gg^Efm, Gs^Fms, Rp, Wwg^Ewf, Wwg^Ewf, Gs^Fet, Wwg^Ewf, Wwg, Rp, Gs^Fms, Gs^Fms, Cv, Gg^Efm, Cv, Wwg, Wwg, Wwg
Wwf, Wwg, Wwg, Cv, Gs^Fms, Gs^Fms, Cv, Gg^Efm, Rp, Wwg, Wwg, Wwg^Ewl, Wwg^Ewf, Wwg, Rp, Gs^Fms, Cv, Gg^Efm, Gg, Cv, Wwg, Wwg, Wwg
Gs^Fms, Wwf, Wwg, Wwg, Wwrg, Cv, Kv, Gg, Gs^Fms, Rp, Rp, Wwg^Ewl, Rp, Rp, Gg, Gg^Efm, Kv, Cv, Gs^Fms, Wwg, Wwg, Wwg, Wwf
Gs^Fms, Gs^Fms, Gll^Fp, Wwg, Wwg, Gs^Fms, Cv, Cv, Gs^Fms, Gs^Fms, Rp, Rp, Rp, Gg^Efm, Gg^Efm, Cv, Cv, Gs^Fms, Gs^Fms, Wwg, Wwg, Wwf, Gs^Fms
Gll^Fp, Gs^Fms, Gs^Fds, Wwg, Wwg, Wwg, Gs^Fms, Gg^Efm, Cv, Kv, Rp, Rp, Rp, Kv, Cv, Gg, Wwg, Gg^Efm, Wwg, Wwg, Gs^Fms, Gs^Fms, Gll^Fp
Gll^Fp, Gll^Fp, Gg^Efm, Gs^Fms, Wwrg, Wwg, Wwg, Wwrg, Gs^Fms, Cv, Rp, Rp, Rp, Cv, Gs^Fms, Wwg, Wwg, Wwg, Wwg, Wwrg, Gs^Fds, Gll^Fp, Gll^Fp
Gs^Fms, Gll^Fp, Gs^Fms, Gs^Fms, Gs^Fms, Wwg, Wwg, Wwg, Wwg, Gs^Fms, Wwf, Wwf^Bsb|, Wwf, Gs^Fms, Wwg, Wwg, Wwg, Wwg, Gs^Fms, Gs^Fms, Gg^Efm, Gll^Fp, Gs^Fms
Gll^Fp, Gs^Fms, Gs^Fds, Gg^Efm, Gg, Wwf, Wwf, Wwg, Wwg, Wwg, Wwf, Wwf^Bsb|, Wwf, Wwf, Wwg, Wwg, Wwf, Gg^Efm, Gll^Fp, Gll^Fp, Gg^Efm, Gs^Fms, Gll^Fp
Gll^Fp, Gll^Fp, Gs^Fms, Gll^Fp, Gll^Fp, Gg^Efm, Gll^Fp, Gs^Fms, Gs^Fms, Wwg, Wwf, Wwf^Bsb|, Wwf, Wwg, Wwg, Wwf, Gs^Fds, Gs^Fms, Gll^Fp, Gll^Fp, Gs^Fms, Gll^Fp, Gll^Fp
Gs^Fms, Gs^Fms, Gs^Fms, Gll^Fp, Gs^Fms, Gs^Fms, Gs^Fms, Gll^Fp, Cv, Wwf, Wwf, Wwf^Bsb|, Rp, Wwg, Cv, Gs^Fms, Gll^Fp, Gs^Fms, Gs^Fds, Gs^Fms, Gs^Fms, Gs^Fds, Gs^Fms
Gll^Fp, Gll^Fp, Gs^Fds, Gg^Efm, Gll^Fp, Gs^Fms, Gll^Fp, Gg^Fet, Cv, Kv, Rp, Rp, Rp, Kv, Cv, Gll^Fp, Gll^Fp, Gs^Fms, Gll^Fp, Gs^Fms, Gll^Fp, Gs^Fds, Gll^Fp
Gs^Fms, Gll^Fp, Gs^Fds, Gs^Fms, Gs^Fms, Gll^Fp, Gs^Fms, Gg^Efm, Gll^Fp, Cv, Rp, Rp, Rp, Cv, Gg^Fet, Gll^Fp, Gs^Fms, Gg^Efm, Gs^Fms, Gll^Fp, Gs^Fms, Gs^Fms, Gll^Fp
Gll^Fp, Gs^Fms, Gll^Fp, Gll^Fp, Gll^Fp, Gs^Fds, Gll^Fp, Gs^Fms, Gll^Fp, Gll^Fp, Rp, 1 Rp, Rp, Gll^Fp, Gll^Fp, Gs^Fms, Gll^Fp, Gll^Fp, Gs^Fms, Gg^Em, Gll^Fp, Gs^Fds, Gll^Fp
Gll^Fp, Gs^Fms, Gll^Fp, Gll^Fp, Gll^Fp, Gll^Fp, Gll^Fp, Gs^Fms, Gg, Gll^Fp, Rp, Rp, Rp, Gll^Fp, Gg, Gs^Fms, Gg, Gll^Fp, Gs^Fms, Gs^Fms, Gll^Fp, Gll^Fp, Gll^Fp
